{
  "level": 1,
  "map": [
    [1,1,1,1,1,1,1,1,1,1,1],
    [1,1,1,1,1,1,1,1,1,1,1],
    [1,1,1,1,1,1,1,1,1,1,1],
    [0,2,2,2,2,2,2,2,2,1,1],
    [1,1,1,1,1,1,1,1,2,1,1],
    [1,1,1,1,1,1,1,1,2,1,1],
    [1,1,1,1,1,1,1,1,2,1,1],
    [1,1,1,1,8,8,8,1,2,1,1],
    [1,1,1,1,8,8,8,8,2,1,1],
    [1,1,1,1,1,8,8,1,2,1,1],
    [1,2,2,2,2,2,2,2,2,1,1],
    [1,2,1,1,1,1,1,1,1,1,1],
    [1,2,1,1,1,1,1,1,1,1,1],
    [1,2,1,1,1,1,1,1,1,1,1],
    [1,2,2,2,2,2,2,2,2,2,9],
    [1,1,1,1,1,1,1,1,1,1,1],
    [1,1,1,1,1,1,1,1,1,1,1],
    [1,1,1,1,1,1,1,1,1,1,1],
    [1,1,1,1,1,1,1,1,1,1,1],
    [1,1,1,1,1,1,1,1,1,1,1]
  ],
  "enemy_path": [
    {
        "x": 192,
        "y": 0
    },
    {
        "x": 192,
        "y": 512
    },
    {
        "x": 640,
        "y": 512
    },
    {
        "x": 640,
        "y": 64
    },
    {
        "x": 896,
        "y": 64
    },
    {
        "x": 896,
        "y": 640
    }
  ]
}