{
  "hasFog": true,
  "cols": 13,
  "rows": 11,
  "tiles": [
    "0000", "0000", "0000", "0010", "0010", "0010", "0010", "0010", "0010", "0010", "0010", "0010", "0010",
    "0000", "0000", "0000", "0010", "0002", "0002", "0002", "0002", "0002", "0010", "0002", "0002", "0010",
    "0000", "0000", "0000", "0010", "0002", "0002", "0002", "0002", "0002", "0010", "0002", "0002", "0010",
    "0000", "0000", "0000", "0010", "0002", "0002", "0002", "0002", "0002", "0010", "0002", "0002", "0010",
    "0000", "0000", "0000", "0010", "0002", "0002", "0002", "0002", "0002", "0010", "0002", "0002", "0010",
    "0010", "0010", "0010", "0010", "0002", "0002", "0002", "0002", "0002", "0010", "0002", "0002", "0010",
    "0010", "0002", "0002", "0010", "0002", "0002", "0002", "0002", "0002", "0010", "0002", "0002", "0010",
    "0010", "0002", "0002", "0010", "0002", "0002", "0002", "0002", "0002", "0010", "0002", "0002", "0010",
    "0010", "0002", "0002", "0010", "0002", "0002", "0002", "0002", "0002", "0010", "0002", "0002", "0010",
    "0010", "0002", "0002", "0002", "0002", "0002", "0002", "0002", "0002", "0002", "0002", "0002", "0010",
    "0010", "0010", "0010", "0010", "0010", "0010", "0002", "0010", "0010", "0010", "0010", "0010", "0010"
  ],
  "items": [
    ["0100", [4, 4], [[0, 2]]],
    ["0100", [11, 1], [[2, "E0S0"], [1, 2]]],
    ["0101", [6, 10], ["E0S0", [1, 1]]],
    ["0102", [6, 0]],
    ["0102", [3, 5]],
    ["0102", [9, 5]],
    ["0011", [4, 3]],
    ["0011", [5, 3]],
    ["0011", [6, 3]],
    ["0011", [7, 3]]
  ]
}