{
  "cols": 10,
  "rows": 5,
  "tiles": [
    1, 0, 1, 1, 1, 1, 1, 1, 1, 1,
    1, 0, 0, 0, 0, 0, 0, 0, 0, 1,
    1, 0, 0, 0, 0, 0, 0, 0, 0, 1,
    1, 0, 0, 0, 0, 0, 0, 0, 0, 1,
    1, 1, 1, 1, 1, 1, 1, 1, 1, 1
  ],
  "items": [
    [
      2, [1, 3], [
      [0, 3]
    ]], [
      3, [1, 0], [
      "E0N0",
      [1, 8]
    ]]
  ]
}
