{
  "cols": 10,
  "rows": 10,
  "tiles": [
    1, 1, 1, 1, 1, 1, 1, 1, 1, 1,
    1, 0, 0, 0, 0, 0, 0, 0, 0, 1,
    1, 0, 0, 0, 0, 0, 0, 0, 0, 1,
    1, 0, 0, 0, 0, 0, 0, 0, 0, 1,
    1, 0, 0, 0, 0, 0, 0, 0, 0, 1,
    1, 0, 0, 0, 0, 0, 0, 0, 0, 1,
    1, 0, 0, 0, 0, 0, 0, 0, 0, 1,
    1, 0, 0, 0, 0, 0, 0, 0, 0, 1,
    1, 0, 0, 0, 0, 0, 0, 0, 0, 1,
    1, 0, 1, 1, 1, 1, 1, 1, 1, 1
  ],
  "items": [
    {
      "Type": 2,
      "pos": [1, 2],
      "params": [
        [0, 2]
      ]
    }, {
      "Type": 3,
      "pos": [1, 9],
      "params": [
        "E0S0",
        [1, 1]
      ]
    }
  ]
}